--------------------------------------------------------------------------------------------------------------------------------------------------------------------------------------------------------
--------------------------------------------------------------------------------------------------------------------------------------------------------------------------------------------------------
--------------------------------------------------------------------------------------------------------------------------------------------------------------------------------------------------------
--------------------------------------------------------------------------------------------------------------------------------------------------------------------------------------------------------
--------------------------------------------------------------------------------------------------------------------------------------------------------------------------------------------------------
--------------------------------------------------------------------------------------------------------------------------------------------------------------------------------------------------------
----------------------------X------B----B-B--------------------X--------?-----------------?---M--------------------------------------------------M-------------------?------?------------X--------------
----------------B-----------------------------o----------------------M------------------------------------------------------------B-------------------X-----o---o---------------------X----------------v
------------------------?------------------B--------X-----------------------X---------------------------B-----------------------------------------------------------------M---X------------------------f
-------------B------------------?------------M--------------X?------------------------M---------M--M--X-----------------------------------------------------------M------------------M-----------------f
-----X--------------------------------B---------------------------------------------------------------------------------------------B--------------?------------------X-----------------M--------------f
-----------M-----------------------------------------------T----------T-------------------X-----------------B-------X--------------------------o------X-----X---------------?--------------------------f
---------------------------------T-------------------------|----------|------------------XX------T------T----------XX----------------T---------------XX-T--XX--T--T------------------------------------f
--------T-----T------------------|-------------------------|----------|-----------------XXX------|------|---------XXX----------------|------T-------XXX-|-XXX--|--|---------------------T---------T----f
m-------|-----|---------E--------|-------------------------|----------|----E-----------XXXX------|------|--------XXXX-------E--------|------|------XXXX-|XXXX--|--|---------------------|---------|----X
XXXXXXXXXXXXXXXXXXXXXXXXXXXXXXXXXXXXXXXXXXXXXXXXXXXXXXXXXXXXXXXXXXXXXXXXXXXXXXXXXXXXXXXXXXXXXXXXXXXXXXXXXXXXXXXXXXXXXXXXXXXXXXXXXXXXXXXXXXXXXXXXXXXXXXXXXXXXXXXXXXXXXXXXXXXXXXXXXXXXXXXXXXXXXXXXXXXXXXXX
