--------------------------------------------------------------------------------------------------------------------------------------------------------------------------------------------------------
--------------------------------------------------------------------------------------------------------------------------------------------------------------------------------------------------------
--------------------------------------------------------------------------------------------------------------------------------------------------------------------------------------------------------
--------------------------------------------------------------------------------------------------------------------------------------------------------------------------------------------------------
--------------------------------------------------------------------------------------------------------------------------------------------------------------------------------------------------------
--------------------------------------------------------------------------------------------------------------------------------------------------------------------------------------------------------
-------------------------------X---X------X-----------B------B-----------------------------B-X----------------o------------------------------------------------------X-------------------?------------X-
----------------------B-------------------------------------------------------M---------------------B----o--------B-----------------B----o------X--o---------------------------------------------------v
-------------------------------------------X---------------------------B-------------------------B------------------------------------------------------?------------------------------------------o---f
------------------------------MBM---B------------------------------------------------------------------------?---------------------B-----------------------------------------X----------------X--------f
-----------------B--------------------------------------X-----------------------o----------------------?------------------------------------X----M------------o------B-----------------------?--------Mf
-------------------------------------------X----------------T----------------X---------------------M---------------------------------?--T-----------------T-----X---------------T---o------T-----------f
----------T-------------------------------XX----------------|--------T------XX-------------------T---------------------T----------------|------T----------|-------------T---T---|----------|-----------f
----------|----------------------------T-XXX----------------|--------|-----XXX-------------------|---------------------|----------------|------|----------|-------------|---|---|----------|-----T-----f
m---------|----------E-----------------|XXXX-----E------E---|--------|----XXXX--E------------E---|-E-------------------|----------------|------|--E----E--|-------------|---|---|----------|-----|-----X
XXXXXXXXXXXXXXXXXXXXXXXXXXXXXXXXXXXXXXXXXXXXXXXXXXXXXXXXXXXXXXXXXXXXXXXXXXXXXXXXXXXXXXXXXXXXXXXXXXXXXXXXXXXXXXXXXXXXXXXXXXXXXXXXXXXXXXXXXXXXXXXXXXXXXXXXXXXXXXXXXXXXXXXXXXXXXXXXXXXXXXXXXXXXXXXXXXXXXXXX
