--------------------------------------------------------------------------------------------------------------------------------------------------------------------------------------------------------
--------------------------------------------------------------------------------------------------------------------------------------------------------------------------------------------------------
--------------------------------------------------------------------------------------------------------------------------------------------------------------------------------------------------------
--------------------------------------------------------------------------------------------------------------------------------------------------------------------------------------------------------
--------------------------------------------------------------------------------------------------------------------------------------------------------------------------------------------------------
--------------------------------------------------------------------------------------------------------------------------------------------------------------------------------------------------------
-------B--------------B---------------------------------------------X---------------B-----M---------------------o-X---------------B--B--X----M---------------X----------?----------o--------------------
------------------------------------------XX-------------------------------------------------------------B------------M---------------------------------------------------------------------o-----B----v
---------------M-----------------X-----------B--------------------?------------------------------------------------------------X----o--------------X---?--M-------------------------X------------------f
-------------------------------------------------X------------?-------------B-----------------M--------------------------?M-------?-----------------------------------?-----------?--------------------f
--------o---B---------B-----------------------------o---X-------------------------------------------------------------------------------------?------------B----------------------------------------o--f
-------T---------------------------------------X--------------------X--B------?-------------------o--------------T------------------------X--?-----------------------------T---------------------------f
-------|-------T---T--------------------------XX-----T-------------XX---------------------------------T----------|------------------T----XX----T---T-----T-----------------|---------------------------f
-------|-------|---|-------------------------XXX-T---|------------XXX----T------------------T---------|----------|--------T---------|---XXX----|---|-----|--------T--------|---------------------------f
m------|-------|---|-----------------------EXXXX-|---|---E-------XXXX----|---E--------------|---------|----------|------E-|-----E---|--XXXX----|---|-----|--------|E----E--|---------------------------X
XXXXXXXXXXXXXXXXXXXXXXXXXXXXXXXXXXXXXXXXXXXXXXXXXXXXXXXXXXXXXXXXXXXXXXXXXXXXXXXXXXXXXXXXXXXXXXXXXXXXXXXXXXXXXXXXXXXXXXXXXXXXXXXXXXXXXXXXXXXXXXXXXXXXXXXXXXXXXXXXXXXXXXXXXXXXXXXXXXXXXXXXXXXXXXXXXXXXXXXX
