--------------------------------------------------------------------------------------------------------------------------------------------------------------------------------------------------------
--------------------------------------------------------------------------------------------------------------------------------------------------------------------------------------------------------
--------------------------------------------------------------------------------------------------------------------------------------------------------------------------------------------------------
--------------------------------------------------------------------------------------------------------------------------------------------------------------------------------------------------------
--------------------------------------------------------------------------------------------------------------------------------------------------------------------------------------------------------
--------------------------------------------------------------------------------------------------------------------------------------------------------------------------------------------------------
------------o-------------X----------------------X---------------?-------?-------------X--------?----------------------X------------------------B----------------BM-------------------?-----------------
----------------M--M-----------------------------------?------------------------------o-----------B-----B----------B-----------------------------------------?---------X--o----------------------------v
-------------------------------------------------------------------------------------------------X------------?----------X-------B---------------------------------------------------------X-----------f
-----------?-------------------------------------------------?---------------------B------------------------------?---?-X----------o----------------------------------------o---------M--X---------B---f
----------------------?-------------------------------------------X------------------X-----------------------------------------------------------------------------------------------o-----------------f
------T--------------X----T---------------------------B----------------------T----------------------X-----------T-----------T-----------M----------?----------X-M-------T------------------T----------Tf
------|-----T-------XX----|---------------T---------T------------------------|----T---------T------XX-----------|-----------|--------------------------T-----XX----T----|-----------T------|----------|f
------|-----|------XXX----|---------------|---------|-------T----------------|----|---------|-----XXX-----------|-----------|---------------------T----|----XXX----|----|-----------|------|----------|f
m-----|-E---|-----XXXX----|---------------|-E--E----|-------|----------------|----|---------|----XXXX-----E-----|-----------|---E-----------------|----|---XXXX----|----|-----------|E-----|----------|X
XXXXXXXXXXXXXXXXXXXXXXXXXXXXXXXXXXXXXXXXXXXXXXXXXXXXXXXXXXXXXXXXXXXXXXXXXXXXXXXXXXXXXXXXXXXXXXXXXXXXXXXXXXXXXXXXXXXXXXXXXXXXXXXXXXXXXXXXXXXXXXXXXXXXXXXXXXXXXXXXXXXXXXXXXXXXXXXXXXXXXXXXXXXXXXXXXXXXXXXX
