--------------------------------------------------------------------------------------------------------------------------------------------------------------------------------------------------------
--------------------------------------------------------------------------------------------------------------------------------------------------------------------------------------------------------
--------------------------------------------------------------------------------------------------------------------------------------------------------------------------------------------------------
--------------------------------------------------------------------------------------------------------------------------------------------------------------------------------------------------------
--------------------------------------------------------------------------------------------------------------------------------------------------------------------------------------------------------
--------------------------------------------------------------------------------------------------------------------------------------------------------------------------------------------------------
--------------------------------?------Xo-----------------------------X------------------------X-----------X----------X------------M----o---------?----------M--------------------------------o---------
----------------------------------------------------------X---------------------------------X--------------------------------------------------------------?------------------?---------M------------X-v
-----------??-----------------------------------------------------?--X----o--------------------------X-----------X------------------o----------------------------------------------------------B-------f
--------------------M-----------X--------B--------------------------------------------------------------M-----oX---------------------------------?-----------------------------------------------------f
-----------------------------------X---X----------M--------------------o---?------------------------X-------------------------X------------------------o--------X-----------------M-----------------B--f
--------------B-B-----T---------------X---------B------------------------------?M-------T-M------------X-T---------------------------?-------------------T--?-------o--?-------T------T-------?--T-----f
----------T-----------|-----------------------------------------------------------------|--------T----XX-|------------------------T----------------------|---------------------|------|----------|-----f
----------|-----------|------------------------------------------------------T----------|--------|---XXX-|--------------------T---|-----------T----------|---------------------|------|----------|-----f
m---------|-------E---|--------------------------------E---------------------|--------E-|--------|--XXXX-|--------------------|-E-|---EE------|----------|---------------------|------|----------|-----X
XXXXXXXXXXXXXXXXXXXXXXXXXXXXXXXXXXXXXXXXXXXXXXXXXXXXXXXXXXXXXXXXXXXXXXXXXXXXXXXXXXXXXXXXXXXXXXXXXXXXXXXXXXXXXXXXXXXXXXXXXXXXXXXXXXXXXXXXXXXXXXXXXXXXXXXXXXXXXXXXXXXXXXXXXXXXXXXXXXXXXXXXXXXXXXXXXXXXXXXX
