--------------------------------------------------------------------------------------------------------------------------------------------------------------------------------------------------------
--------------------------------------------------------------------------------------------------------------------------------------------------------------------------------------------------------
--------------------------------------------------------------------------------------------------------------------------------------------------------------------------------------------------------
--------------------------------------------------------------------------------------------------------------------------------------------------------------------------------------------------------
--------------------------------------------------------------------------------------------------------------------------------------------------------------------------------------------------------
--------------------------------------------------------------------------------------------------------------------------------------------------------------------------------------------------------
-----B------------------------?---------------o--------------------o----M-----------------------?----------X-----------------------------------------------------------------?--------------------------
--------X-------------------------------------------------------------B---------------?-------------------------------------------------o--------------------M----------?-----------------o----?-------v
------------------------X------------------------------?----?----------------o---B------------------------------------B-----------------------------------------B------X-------------------------------f
--------------------------------------X---------------------------------------------------?---X----------------------------------------X---------M--X-----------------------o--------X-----------------f
---------------?-----M-------------------------------M------------------------M---X---o----------------------------------M-------------------?-----------------------------------X--B------------------f
----------------------------------o--o------?---o------------X------T--T-----X-------------X-----X--------T--------T-----------T---------------------------------------------T--------?----------------f
------------T-------------T---------------------------------XX------|--|----XX-----T------T-----XX--------|--------|-----------|------------------------------------------T--|-------------------------f
------------|-------------|--------------------------------XXX------|--|---XXX-----|------|----XXX--------|--------|-----------|-------------------------T----------------|--|--T----------------------f
m-----------|-------------|-------------------------------XXXX------|--|--XXXX-----|------|---XXXX--------|--------|-----------|-------------------------|----------------|--|--|----------------------X
XXXXXXXXXXXXXXXXXXXXXXXXXXXXXXXXXXXXXXXXXXXXXXXXXXXXXXXXXXXXXXXXXXXXXXXXXXXXXXXXXXXXXXXXXXXXXXXXXXXXXXXXXXXXXXXXXXXXXXXXXXXXXXXXXXXXXXXXXXXXXXXXXXXXXXXXXXXXXXXXXXXXXXXXXXXXXXXXXXXXXXXXXXXXXXXXXXXXXXXX
