--------------------------------------------------------------------------------------------------------------------------------------------------------------------------------------------------------
--------------------------------------------------------------------------------------------------------------------------------------------------------------------------------------------------------
--------------------------------------------------------------------------------------------------------------------------------------------------------------------------------------------------------
--------------------------------------------------------------------------------------------------------------------------------------------------------------------------------------------------------
--------------------------------------------------------------------------------------------------------------------------------------------------------------------------------------------------------
--------------------------------------------------------------------------------------------------------------------------------------------------------------------------------------------------------
-----M----------X--?X--------------------------------------------B---X--------------------M--------------------------------------------------X-------------------------M--------------------------M-----
----------B------------------X-----------o----------o-----------------------------------------------X--------------X?--------B-----------------------------------B-------B----------------------------Mv
-----------------------------------------------------------?--------------------------------------------------------------------------------M------------?---------------------------------------------f
------------------B--------------------------------?-----------------------------M-------------X-------------------------B----------B?-----------------------------o------------X--------?---------M---f
---------------------B----------------------------------------------------------------X-----------------------------M--X-------------------B---B----------------------------X--------------------------f
-------------------------T--------o-------------X--------------------T-----------------------------?----T---------?------------------------------T-?---------------------M-----------------------------f
-------------------------|---------------------XX--------T---T-------|----------------------------------|--------T---------------------------T---|--------------------------------------------T--------f
--------T----T-----------|-----------------T--XXX--T-----|---|-------|----------------------------------|--------|---T------------------T----|---|--------------------------------------------|--------f
m-------|--E-|----EE----E|-----------------|-XXXX--|-----|---|-------|------------E---------------------|--------|---|------E----E------|----|---|--------------------------------------------|--E-----X
XXXXXXXXXXXXXXXXXXXXXXXXXXXXXXXXXXXXXXXXXXXXXXXXXXXXXXXXXXXXXXXXXXXXXXXXXXXXXXXXXXXXXXXXXXXXXXXXXXXXXXXXXXXXXXXXXXXXXXXXXXXXXXXXXXXXXXXXXXXXXXXXXXXXXXXXXXXXXXXXXXXXXXXXXXXXXXXXXXXXXXXXXXXXXXXXXXXXXXXX
