--------------------------------------------------------------------------------------------------------------------------------------------------------------------------------------------------------
--------------------------------------------------------------------------------------------------------------------------------------------------------------------------------------------------------
--------------------------------------------------------------------------------------------------------------------------------------------------------------------------------------------------------
--------------------------------------------------------------------------------------------------------------------------------------------------------------------------------------------------------
--------------------------------------------------------------------------------------------------------------------------------------------------------------------------------------------------------
--------------------------------------------------------------------------------------------------------------------------------------------------------------------------------------------------------
------------X--------------------------------------------X---------------?----------B------------------------------------------------------------------------o-------o-------------X---------B----------
-----------------------------?o-----?------------------M--------------------------------------X-----------------------------------------------------------X-------------------------------X------------v
-----?----------------------------------------------------------------------------------------------------------------------o----M----B--------------B--?----------------------------------------------f
-----------------------------------------------------------------------M-------B?--------------------B-B------------------------------------------------------M--?--------------------------------o----f
-------------------o----------------M----o-----------------------------------------------------------------------------------------------------------------------------------------B-------------------f
------T-----------------------X-----------------M-------------X---------------?---T-------T-------------------o---------T-----------------M-T------T------------------------------T---------B----------f
------|---T---T-----------T--XX------------------------------XX-------------------|-------|-----------------------------|---------------T---|------|---------T--------------------|--------------------f
------|---|---|-----------|-XXX----T----------T-------------XXX---------T---------|-------|----T------------------------|---------------|---|------|---------|--------T----T------|--------------------f
m-----|---|---|---------E-|XXXX----|----------|------------XXXX---------|---------|-------|----|---------E-------E------|---------------|---|------|---------|--------|----|------|------------E-------X
XXXXXXXXXXXXXXXXXXXXXXXXXXXXXXXXXXXXXXXXXXXXXXXXXXXXXXXXXXXXXXXXXXXXXXXXXXXXXXXXXXXXXXXXXXXXXXXXXXXXXXXXXXXXXXXXXXXXXXXXXXXXXXXXXXXXXXXXXXXXXXXXXXXXXXXXXXXXXXXXXXXXXXXXXXXXXXXXXXXXXXXXXXXXXXXXXXXXXXXX
