--------------------------------------------------------------------------------------------------------------------------------------------------------------------------------------------------------
--------------------------------------------------------------------------------------------------------------------------------------------------------------------------------------------------------
--------------------------------------------------------------------------------------------------------------------------------------------------------------------------------------------------------
--------------------------------------------------------------------------------------------------------------------------------------------------------------------------------------------------------
--------------------------------------------------------------------------------------------------------------------------------------------------------------------------------------------------------
--------------------------------------------------------------------------------------------------------------------------------------------------------------------------------------------------------
------------------------------X-------------------------------?-------------o----------------o----------------------------Xo-----------M---------------------X?------o----------o---------X-------------
---------------B--B---------X-------?-------------?---M----X------B------------X---------------M---------------------M-----------B-------------------------------------------------------------M-------v
----------------------------------------------------------------------------------------------------B--------o----------------------------M--B----oB--------------------------------?------------------f
---------------------------M---------------------------------------------------------------X----------------B--?-------X-------X---------------------?--------------B----------------------------------f
-----------B------?-------B------B-------X----------------------B---------X------------------------------------------------------------------------------------------------------------------------XX--f
-----------------------------------------------------------T---o------T------------------X----?-----T----------------o--T--------X---------?---------------------X-------------------B-----------------f
----------------------------T------------------------------|----------|----------T------XX----------|-------------------|-------XX-----T------------------------XX----------------T--------------------f
---------T------------------|---------------------T--------|-------T--|----T-----|-----XXX----------|-------------------|------XXX-----|---------T-------------XXX----------T-----|--------------------f
m--------|------------------|--------------E------|------E-|-------|--|----|-----|-E--XXXX----------|------------E------|--E--XXXX-----|--E------|------------XXXX----------|-----|E-------------------X
XXXXXXXXXXXXXXXXXXXXXXXXXXXXXXXXXXXXXXXXXXXXXXXXXXXXXXXXXXXXXXXXXXXXXXXXXXXXXXXXXXXXXXXXXXXXXXXXXXXXXXXXXXXXXXXXXXXXXXXXXXXXXXXXXXXXXXXXXXXXXXXXXXXXXXXXXXXXXXXXXXXXXXXXXXXXXXXXXXXXXXXXXXXXXXXXXXXXXXXX
