--------------------------------------------------------------------------------------------------------------------------------------------------------------------------------------------------------
--------------------------------------------------------------------------------------------------------------------------------------------------------------------------------------------------------
--------------------------------------------------------------------------------------------------------------------------------------------------------------------------------------------------------
--------------------------------------------------------------------------------------------------------------------------------------------------------------------------------------------------------
--------------------------------------------------------------------------------------------------------------------------------------------------------------------------------------------------------
--------------------------------------------------------------------------------------------------------------------------------------------------------------------------------------------------------
-------X------------?--------B----------------------------------------------------------------------------------------------o---X-------X-------------------------B---?----------------------------?----
--------------B----------------------?--------------------------------------------------------------------------------------------------------X-------------------------------------?------------------v
----------B----------------?------------------?--------M--X--------M----------o--B--------------------------------------?------------------------------------------------B---------X-------------------f
-------------------------------?----------------------------------------------------------------------------o---o--------------------------------M-----------------------------------------------------f
---------------------------------B?-------------------------M--M----------------------------------------M----------------------------------X---------------------o-----B----------------------------M--f
---------------------------------------X-----X----------------M--------T--X-------------------X------------------M-------X-----T--------T-------T-B------------T-------------------------?----?--------f
--------------------------------------XX----XX------------T------------|---------------------XX-------------------------XX-----|--------|-------|--------------|---T-----------------------------------f
-------------------T----T------------XXX-T-XXX----T-------|------------|-----------------T--XXX------------------------XXX-----|--------|-------|--T-------T---|---|------------------------------T----f
m------------------|E---|-----------XXXX-|XXXX----|------E|------------|-----------------|-XXXX-----------------------XXXX-----|--------|-------|--|-------|---|---|-------E-----------E----------|----X
XXXXXXXXXXXXXXXXXXXXXXXXXXXXXXXXXXXXXXXXXXXXXXXXXXXXXXXXXXXXXXXXXXXXXXXXXXXXXXXXXXXXXXXXXXXXXXXXXXXXXXXXXXXXXXXXXXXXXXXXXXXXXXXXXXXXXXXXXXXXXXXXXXXXXXXXXXXXXXXXXXXXXXXXXXXXXXXXXXXXXXXXXXXXXXXXXXXXXXXX
