--------------------------------------------------------------------------------------------------------------------------------------------------------------------------------------------------------
--------------------------------------------------------------------------------------------------------------------------------------------------------------------------------------------------------
--------------------------------------------------------------------------------------------------------------------------------------------------------------------------------------------------------
--------------------------------------------------------------------------------------------------------------------------------------------------------------------------------------------------------
---o-?--------------X---------M-----------------------------------------------------------X-----------------------------------------------------------------M-----B-------------------------------------
---------------------------------B------?-----o------------o--------?--?-M------M---------------------------X----B----------------X----------------------------M---------X-----------X------------------
----?------------B-----------------------------------------------------------------------------X--------------B---------X-------X--?---------X---------------------------------X--------------------B---
--------------------X--------------------------------------M------------------------------------------B---------------X-------------------------------o--M----------M------o--------M------------------v
----------------------------o---?-----------------------o------------------------?----------------------------------------o--------o----M--------------------B?-------------------------B--------------f
---------------------B-------------------?-----------M--o--B---X--------------B--------o-----------------?--------------------------Xo-------M--------B---------------------B---?----------------------f
-------------------------------------------------------------------------------------------------------------------------------------------------------------------------------------------------------f
--------------------------o----------------o-----------o-------------B------------------------------------------M-----T---------------------------------------------B----------------------------------f
---------------T----------------T-------------------------------------------------------------------------------------|--------------------------------------------------------------------------------f
---------------|----------------|------------T-----------------------------------------T------T-----------------------|--------------------------------------------------------------------------------f
m---E----------|-------------E--|--E---------|-----------------------------------------|------|-----------------------|-----------------------------------------------E--------------------------------X
XXXXXXXXXXXXXXXXXXXXXXXXXXXXXXXXXXXXXXXXXXXXXXXXXXXXXXXXXXXXXXXXXXXXXXXXXXXXXXXXXXXXXXXXXXXXXXXXXXXXXXXXXXXXXXXXXXXXXXXXXXXXXXXXXXXXXXXXXXXXXXXXXXXXXXXXXXXXXXXXXXXXXXXXXXXXXXXXXXXXXXXXXXXXXXXXXXXXXXXX
