--------------------------------------------------------------------------------------------------------------------------------------------------------------------------------------------------------
--------------------------------------------------------------------------------------------------------------------------------------------------------------------------------------------------------
--------------------------------------------------------------------------------------------------------------------------------------------------------------------------------------------------------
--------------------------------------------------------------------------------------------------------------------------------------------------------------------------------------------------------
--------------------------------------------------------------------------------------------------------------------------------------------------------------------------------------------------------
--------------------------------------------------------------------------------------------------------------------------------------------------------------------------------------------------------
--------------------------------------------------------------------------------------------------------------------------------------------------------------------------------------------------------
-------------------------------------------------------------------------------------------------------------------------------------------------------------------------------------------------------v
-------MB--------B???----------------------------B?-------------------------BB---------------M?------M?MM?-----------?MB?-------o-o--B?BMM--------------------------------------------??M??MM----------f
----------------------------------------------------------------------------------------------------------------------------------------------------------------?-?M?----------M?----------------------f
---------------------------------?-----o-------------------------------------------BBBMBM?-----o-------------X----------o--o----------------o------------o------------------------o--------------------f
------Xo------T------o--T--------o-T------X-------X-----------T--o-o---M--??MB---MM--------o--------o--BB??---------oBBTo-----o------M?BM--X---------T----X----o------X----T--o------------------------f
---oo-XXo-----|----o----|-X----o---|-o---XX---T--XX----o---o--|-------T--T------o--oB?B-MBBB?---MBBT-?M--BMM-----------|----------X-------XX-o-------|----XX---------XX----|-------------o--------o----f
-----oXXX-----|o--------|----------|----XXX---|-XXX------o-o--|-------|--|-----------------o-------|---------T---------|-------------o---XXX---o-----|----XXX------oXXX----|----------------T----o-----f
m-----XXXXE---|---EE----|---------E|---XXXX-E-|XXXX-----E-----|-------|--|---------------E-------E-|---------|E-----E--|--------------E-XXXX-E-------|----XXXX-----XXXX----|----------------|----E----EX
XXXXXXXXXXXXXXXXXXXXXXXXXXXXXXXXXXXXXXXXXXXXXXXXXXXXXXXXXXXXXXXXXXXXXXXXXXXXXXXXXXXXXXXXXXXXXXXXXXXXXXXXXXXXXXXXXXXXXXXXXXXXXXXXXXXXXXXXXXXXXXXXXXXXXXXXXXXXXXXXXXXXXXXXXXXXXXXXXXXXXXXXXXXXXXXXXXXXXXXX
