--------------------------------------------------------------------------------------------------------------------------------------------------------------------------------------------------------
--------------------------------------------------------------------------------------------------------------------------------------------------------------------------------------------------------
--------------------------------------------------------------------------------------------------------------------------------------------------------------------------------------------------------
--------------------------------------------------------------------------------------------------------------------------------------------------------------------------------------------------------
--------------------------------------------------------------------------------------------------------------------------------------------------------------------------------------------------------
--------------------------------------------------------------------------------------------------------------------------------------------------------------------------------------------------------
--------------------------------------------------------------------------------------------------------------------------------------------------------------------------------------------------------
-------------------------------------------------------------------------------------------------------------------------------------------------------------------------------------------------------v
------------B-------------------------------------------------?B-?----------------------X--------------?B?BBB----??------?B??---------------------------------------------------------o----------------f
-------------------------------X-------------------------X-------------o------------------X---------------------BBB?B?B?---B-X------------------------B-------B?BB?---------------------B-?------------f
-----------o--------------------------------o---X---------------------------------------o-------------------o-----------------------o-o-------o-----BM?BBB-------------B-B?----------------o-------o--of
------o---X--o----X-----?B-?B-o--------------------o--------B?-BB?B??-----B----------BB-BB-B?---------------------o--o------o------T-----------Xo-X------X--------M-o-------MB------------------T----X-f
-----------------XX-------------T------------T--o-------o--To----------o------???----o-----B??--B-----------T--------T------oT-----|--M?B?--------XX-----XX---------T----o--------?B?B----o-T---|------f
-----------o----XXX-------------|------T-----|-------------|----------------------------------XT-----T------|--------|o------|-o---|---------T--X-XXX--T-XXX--To----|-----o----T------------|---|------f
m-E------------XXXX--E-----E----|-EE---|-----|E---------E--|--------E--------------------------|E--E-|------|--------|----E--|E----|--E-E----|----XXXX-|-XXXX-|-----|--X-------|---EE------E|--E|E-----X
XXXXXXXXXXXXXXXXXXXXXXXXXXXXXXXXXXXXXXXXXXXXXXXXXXXXXXXXXXXXXXXXXXXXXXXXXXXXXXXXXXXXXXXXXXXXXXXXXXXXXXXXXXXXXXXXXXXXXXXXXXXXXXXXXXXXXXXXXXXXXXXXXXXXXXXXXXXXXXXXXXXXXXXXXXXXXXXXXXXXXXXXXXXXXXXXXXXXXXXX
