--------------------------------------------------------------------------------------------------------------------------------------------------------------------------------------------------------
--------------------------------------------------------------------------------------------------------------------------------------------------------------------------------------------------------
--------------------------------------------------------------------------------------------------------------------------------------------------------------------------------------------------------
--------------------------------------------------------------------------------------------------------------------------------------------------------------------------------------------------------
--------------------------------------------------------------------------------------------------------------------------------------------------------------------------------------------------------
--------------------------------------------------------------------------------------------------------------------------------------------------------------------------------------------------------
--------------------------------------------------------------------------------------------------------------------------------------------------------------------------------------------------------
-------------------------------------------------------------------------------------------------------------------------------------------------------------------------------------------------------v
-----------------?------X---o---o---------------------------------------------X-----------BB???------------------------------------------------------??B??---------------------------------------------f
-----------------------------------------X------BB-------------BBBB?B?--------------------------------------------------------------------------------------??------------X----------------------------f
-----M?---B--------------------------------o-o-------------------------?BM-----------------------------------BB----------------------------------------------------------------------------------------f
-------B?---------------------T------Xo---------------------oT------T------------?B??---T------------------B-o----?BBBB??---------o---------------------------------------------oX-----------------MBB-f
------------------------------|----------------------------B-|-?B?B?|---o--BB?BBB-------|---------o-BB?B----------------------------------?BB?B?---------T-----------------------XX------------T-------f
------------------------------|----------------T-------------|------|-----T-------------|-------------------T-------oo-------T----------T----o-------o---|------T----------------XXX-------T---|----T--f
m-----------------------------|----------------|-------------|------|-----|-------------|------------E----E-|------------E---|E--E------|-------E--------|-----E|----------------XXXX---E--|---|----|--X
XXXXXXXXXXXXXXXXXXXXXXXXXXXXXXXXXXXXXXXXXXXXXXXXXXXXXXXXXXXXXXXXXXXXXXXXXXXXXXXXXXXXXXXXXXXXXXXXXXXXXXXXXXXXXXXXXXXXXXXXXXXXXXXXXXXXXXXXXXXXXXXXXXXXXXXXXXXXXXXXXXXXXXXXXXXXXXXXXXXXXXXXXXXXXXXXXXXXXXXX
